NO textures/north.xpm
SO textures/south.xpm
WE textures/west.xpm
EA textures/east.xpm

F 30,30,30
C 180,180,180

1111111111                 1111111111111111111
10100000011111111111111111111            1     1
10111111000000000000000000E001          101     1  
10000001011111111111111111111            1     1
1010110101                 1                 1
1000100001                 1                 1
1111111111                 1111111111111111111
