NO textures/north.xpm
SO textures/south.xpm
WE textures/west.xpm
EA textures/east.xpm

F 30,30,30
C 180,180,180

1111111111                 1111111111111111111
1010000001111111111111111111                 1
10111111000000000000000000E01     1           1
1000000101111111111111111111                 1
1010110101                 1                 1
1000100001                 1                 1
1111111111                 1111111111111111111
