NO textures/north.xpm
SO textures/south.xpm
WE textures/west.xpm
EA textures/east.xpm

F 20,20,20
C 170,170,170

111111
100001
10N000
100001
111111
