NO    "fea.xpm"
SO 	"hello.xpm"
EA 	"another.xpm"
WE   "test.txt"
F	253,222,12
C	122,231,133

111111111
10000011111
1000N011111
10011111001
1001 1111001
11111111111