NO    "fea.xpm"
SO 	"hello.xpm"
EA 	"another.xpm"
WE   "test.txt"
F	233,222,12
C	122,231,133

111111111
100000111
1000N011110
10011111001
1001 1111001
11111111111